


   WWWWWWWWWWWW
   W          W
    W          W
    W          W
    W     P    W
    W          W
    W       A  W
    W          W
   WWWWWWWWWWWW
